w,m,m,m,m,m,m,m,m,m,m,m,m,m,w
w,p,g,g,b,b,g,g,g,g,g,g,g,g,w
w,g,g,g,g,2,g,g,m,g,m,g,m,g,w
w,b,g,b,g,g,g,g,g,g,g,g,g,g,w
w,b,b,b,m,g,m,g,m,g,m,g,m,g,w
w,g,g,g,g,g,g,g,g,g,g,g,g,g,w
w,g,m,g,m,g,m,g,m,1,m,g,m,g,w
w,g,g,g,g,g,g,g,g,g,g,g,g,g,w
w,g,m,g,m,g,m,g,m,g,m,g,m,g,w
w,g,4,g,g,g,g,g,g,g,g,g,g,g,w
w,g,m,g,m,g,m,g,g,3,g,g,m,g,w
w,g,g,g,g,g,g,g,g,g,g,g,g,g,w
w,m,m,m,m,m,m,m,m,m,m,m,m,m,w
