w,m,m,m,m,m,m,m,m,m,m,m,m,m,w
w,p,g,g,g,g,g,g,g,g,g,g,g,g,w
w,g,g,g,m,g,m,g,m,g,m,g,m,g,w
w,b,g,b,g,g,g,g,g,g,g,g,g,g,w
w,b,b,b,m,g,m,g,m,g,m,g,m,g,w
w,g,g,g,g,g,g,g,g,g,g,g,g,g,w
w,g,m,g,m,g,m,g,m,g,m,g,m,g,w
w,g,g,g,g,g,g,g,g,g,g,g,g,g,w
w,g,m,g,m,g,m,g,m,g,m,g,m,g,w
w,g,g,g,g,g,g,g,g,g,g,g,g,g,w
w,g,m,g,m,g,m,g,m,g,m,g,m,g,w
w,g,g,g,g,g,g,g,g,g,g,g,g,g,w
w,m,m,m,m,m,m,m,m,m,m,m,m,m,w
