w,w,w,w,w,w,w,w,w,w,w,w,w,w,w
w,g,g,g,g,b,b,b,g,g,g,g,g,g,w
w,g,m,g,m,g,m,b,m,g,m,g,m,g,w
w,g,g,g,g,g,g,g,g,g,g,g,g,g,w
w,g,m,g,m,b,m,g,m,g,m,g,m,g,w
w,g,g,g,g,b,g,g,g,g,g,g,g,g,w
w,g,m,g,m,b,m,g,m,g,m,g,m,g,w
w,g,g,g,g,b,g,g,g,g,g,g,g,g,w
w,g,m,g,m,b,m,g,m,g,m,g,m,g,w
w,g,g,g,g,g,g,g,b,b,g,g,g,g,w
w,g,m,b,m,g,m,g,m,b,m,g,m,g,w
w,g,g,b,g,g,g,g,b,b,g,g,g,g,w
w,g,m,g,m,g,m,g,m,g,m,g,m,g,w
w,g,g,g,g,g,g,g,g,g,g,g,g,g,w
w,w,w,w,w,w,w,w,w,w,w,w,w,w,w
